NO ./textures/north_wall.xpm
SO ./textures/south_wall.xpm
WE ./textures/west_wall.xpm
EA ./textures/east_wall.xpm

F 100,50,25
C 135,206,235

11111111111111111111
10000000000000000001
10110000001100000101
10010000000100000101
10000111110000011101
10000100010000010001
10000100010000010001
10000100010000010001
10000111110000011101
10000000000000000001
10001111001111100001
10001000000000100001
10001000N00000100001
10001000000000100001
10001111001111100001
10000000000000000001
10111000000000011101
10001000000000100001
10001000000000100001
11111111111111111111
