NO ./textures/N/BRICK_2B.PNG
SO ./textures/S/BRICK_3B 12.41.24 AM.PNG
WE ./textures/W/BRICK_3D 12.41.24 AM 12.41.32 AM.PNG
EA ./textures/E/BRICK_1A.PNG

C 135,206,235
F 139,69,19

1111111111111110000001
111111000000001
111111111111111
1111000N0001111
111000000000111
110000000000011
100001111100001
110000111000011
111000010000111
111100000001111
111110000011111
111111000111111
111111111111111
