NO ./textures/N/BRICK_2B.PNG
SO ./textures/S/BRICK_3B 12.41.24 AM.PNG
WE ./textures/W/BRICK_3D 12.41.24 AM 12.41.32 AM.PNG
EA ./textures/E/BRICK_1A.PNG

F 220,100,0
C 225,30,0

    1111111
    1000001
    1000001
    1000001
111111000001
10000000N001
10000000001
111111000001
    1000001
    1000001
    1000001
    1111111
